OnewireKeypad	KEYWORD2
Getkey	KEYWORD2
SetHoldTime	KEYWORD2
SetDebounceTime	KEYWORD2
SetKeypadVoltage	KEYWORD2
Key_State	KEYWORD2
Readpin	KEYWORD2
LatchKey	KEYWORD2
checkLatchedKey	KEYWORD2
addEventKey	KEYWORD2
deleteEventKey	KEYWORD2
ListenforEventKey	KEYWORD2

Serial	LITERAL1
Lcd	LITERAL1

PRESSED	LITERAL1
RELEASED	LITERAL1
HELD	LITERAL1
NO_KEY	LITERAL1

ExtremePrec	LITERAL1
HighPrec	LITERAL1
MediumPrec	LITERAL1
LowPrec	LITERAL1

